VVVVVVVVVVVVVVVVVVVV
OPPPPPPHVVVVVVVVVVVO
OVVVVVAMVVNVVVVVEVVO
OCPPPPGBDPPPPPPPPPPO
OCVVVVVVVVVVVVVVVVVO
OCPPPPPPPPPPPPPPPPOO
OCVHVVVVVVVVVVVVVVVO
OCVMVVPPPPPPPPHPVPOO
OCGBDVCVVVVVVVVVVVVO
OCVVVVCPPVVVVVVVVVVO
OPPPPPPPPPPPPPPVCPPO
OVVVVVVVVVVVVVVVCVVO
OVVEVVVVVVVVVVVVCVVP
WWWWWWWWWWWWWWWVCWWW
WWWWWWWWWWWWWWWWWWWW