VVVVVVVVVVVVVVVVVVVV
WPPPPPPHVVVVVVVVVVVW
WVVVVVAMVVNVVVVVEVVW
WCPPPPPBPPPPPPPPPPPW
WCVVVVVVVVVVSVVVVVVW
WCPPPPPVPPPPPPPPPPWW
WCVVVVVVVVSVVVVVVVVW
WCVVVVPPPPPPPPPPPPWW
WCVVVVCVVVVVHVVVCVVW
WCVVVVCPPVVVMVVVCVVW
WPPPPPPPPPPPBPPVCPPW
WVVVVVVVVVVVVVVVCVVW
WVVEVVVSVVVVVVVVCVVP
WWWWWWWWWWWWWWWVCWWW
WWWWWWWWWWWWWWWWWWWW