VVVVVVVVVVVVVVVVVVVV
WPPPPPPHVVVVVVVVVVVW
WVVVVVAMVVNVVVVVEVVW
WCPPPPPBPPPPPPPPPPPW
WCVVVVVVVVVVVVVVVVVW
WCPPPPPPPPPPPPPPPPWW
WCVVVVVVVVVVVVVVVVVW
WCVVVVPPPPPPPPPPPPWW
WCVVVVCVVVVVVVVVCVVW
WCVVVVCPPVVVVVVVCVVW
WPPPPPPPPPPPPPPVCPPW
WVVVVVVVVVVVVVVVCVVW
WVVEVVVVVVVVVVVVCVVP
WWWWWWWWWWWWWWWVCWWW
WWWWWWWWWWWWWWWWWWWW