VVVVVVVVVVVVVVVVVVVV
WPPPPPPVVVVVVVVVVVVW
WVVVVVAVVVNVVVVVEVVW
WCPPPPPPPPPPPPPPPPPW
WCVVVVVVVVVVSVVVVVVW
WCPPPPPPPPPPPPPPPPWW
WCVVVVVVVVSVVVVVVVVW
WCVVVVPPPPPPPPPPPPWW
WCVVVVCVVVVVVVVVCVVW
WCVVVVCPPVVVVVVVCVVW
WPPPPPPPPPPPPPPVCPPW
WVVVVVVVVVVVVVVVCVVW
WVVEVVVSVVVVVVVVCVVP
WWWWWWWWWWWWWWWVCWWW
WWWWWWWWWWWWWWWWWWWW