VVVVVVVVVVVVVVVVVVVV
WPPPPPPVVVVVVVVVVVVW
WCVVVVVVVVNVVVVVEVVW
WCPPPPPPPPPPPPPPPPPW
WCVVVVVVVVVVVVVVVVVW
WCPPPPPPPPPPPPPPPPWW
WCVVVVVVVVVVVVVVVVVW
WCVVVVPPPPPPPPPPPPWW
WCVVVVVVVVVVVVVVCVVW
WCVVVVVPPVVVVVVVCVVW
WPPPPPPPPPPPPPPVCPPW
WVVVVVVVVVVVVVVVCVVW
WVVEVVVVVVVVVVVVCVVP
WWWWWWWWWWWWWWWVCWWW
WWWWWWWWWWWWWWWWWWWW