PPVVVHVVVCVVVVCVVVOO
VOVVVMVVVCVVVVCVVVOO
VPVPGBDPPVPPHPCSVVOO
VOVVVVCPPPPPMPCPPPPP
VOVVVVCVVCVVBDCPCVCW
VOVVVPPVVCVVVVHVCVCW
VOVVVVPPPCVVSVMVCVCW
VOVVVVVVPPPPPGBDCPCE
VOVVVVVVCVVVVVVVCPPP
VOEVVVVVCVVVVVVVCVVW
VOVVAVVVCVVVVVVVCVVW
WWWWWWWPCPWWWOWWCWWW
WVVVVVVVCVVVVOVVCEWW
WWWWWWWWWWWWWOWWWWWW
WWWWWWWWWWWWWWWWWWWW

