VVVVVVVVVVVVVVVVVVVV
WPPPPPPVVVVVVVVVVVVW
WCVAVVVVVVNVVVVVEVVW
WCPPPPPPPPPPPPPPPPPW
WCVVVVVVVVVVVVVVVVVW
WCPPPPPPPPPPPPPPPPWW
WCVVVVVVVVVVVVVVVVVW
WCVVVVPPPPPPPPPPPPWW
WCVVVVCVVVVVVVVVCVVW
WCVVVVCPPVVVVSVVCVVW
WPPPPPPPPPPPPPPVCPPW
WVVVVVVVVVVVVVVVCVVW
WVVEVSVVVVVVVVVVCVVP
WWWWWWWWWWWWWWWVCWWW
WWWWWWWWWWWWWWWWWWWW