XXXXXXXXXXXXXXXXXXXX
OPPPPPPHVVVVVVVVVVVO
OVVVVVVMVVNVVVVVVVVO
OCPPPPGBDPPPPPPPPPPO
OCVVVVVVVVVVVVVVVVVO
OCPPPPPPPPPPPPPPPPOO
OCVHVVVVVVVVVVVVVVVO
OCVMVVPPPPPPPPHPVPOO
OCGBDVCVVVVVVVVVVVVO
OCVVVVCPPVVVVVVVVVVO
OPPPPPPPPPPPPPPVCPPO
OVVVVCVVVVVVVVVVCVVO
OVAEVCPVVVVVSVPVCVVP
WWWWWWWWWWWWWWWVCWWW
WWWWWWWWWWWWWWWWWWWW