VVVVVVVVVVVVVVVVVVVV
PPVCHVVCVVVVCEVVVVVO
VOACMVVCVSVVCVVVVVVO
VPPGBDPNPPHPCVVVVVVO
VOVVVCPPPPMPPPPGVVVO
VOVVVCVCVVBDVVCVVVVO
VOVPPCECVVVVVVCVVVVO
VOVVPPPCVVVVVVCVVVVO
VOVVVVPPPPPPPPCPPPPO
VOVVVVVVVVVVVVCVVVVO
VOEVVVVVVVVVVVVVVVVO
VOVVVVVVVVVVVVVVVVVO
WWWWWWWWWWWWWWWWWWWW
WWWWWWWWWWWWWWWWWWWW
WWWWWWWWWWWWWWWWWWWW
